project,bug,cornTotal,corn2,cornN,cornIN,isCorn
jdt,356620,23,13,10,6,1
jdt,331649,19,14,5,4,1
jdt,486011,21,16,5,4,1
jdt,71761,66,43,23,13,1
jdt,188796,41,38,3,3,1
jdt,512741,22,15,7,5,1
jdt,399794,44,20,24,19,1
jdt,426290,5,3,2,1,1
jdt,19063,220,193,27,26,1
jdt,66533,2,1,1,1,1
jdt,499708,6,2,4,1,1
jdt,459415,16,13,3,3,1
jdt,70602,3,1,2,1,1
jdt,520651,31,25,6,1,1
jdt,178213,2,1,1,1,1
jdt,511950,9,7,2,2,1
jdt,247941,11,9,2,1,1
jdt,425152,2,1,1,1,1
jdt,518301,30,16,14,14,1
jdt,519723,22,9,13,12,1
jdt,202470,71,51,20,7,1
jdt,186342,28,19,9,5,1
jdt,409586,3,2,1,1,1
jdt,74286,1,0,1,1,1
jdt,399979,2,1,1,1,1
jdt,30511,4,2,2,2,1
jdt,379078,6,4,2,2,1
jdt,438458,12,6,6,1,1
jdt,489702,15,13,2,1,1
jdt,271680,7,4,3,1,1
jdt,466308,3,2,1,1,1
jdt,424290,19,9,10,10,1
jdt,506878,37,28,9,7,1
jdt,517808,6,4,2,1,1
jdt,6930,48,35,13,7,1
jdt,514089,50,28,22,19,1
jdt,317841,17,8,9,9,1
jdt,413569,3,2,1,1,1
jdt,517269,9,6,3,3,1
jdt,424415,7,5,2,2,1
jdt,481796,147,103,44,39,1
jdt,424710,1,0,1,1,1
jdt,42196,3,2,1,1,1
jdt,441693,8,3,5,1,1
jdt,419664,2,1,1,1,1
jdt,391895,33,24,9,9,1
jdt,487421,16,12,4,3,1
jdt,106541,13,11,2,2,1
jdt,481332,7,4,3,1,1
jdt,399793,3,1,2,1,1
jdt,487780,11,7,4,4,1
jdt,440477,41,34,7,4,1
jdt,359943,9,4,5,2,1
jdt,200124,15,12,3,3,1
jdt,418096,13,9,4,3,1
jdt,130778,30,12,18,7,1
jdt,179684,3,2,1,1,1
jdt,478042,21,17,4,1,1
jdt,399792,6,4,2,2,1
jdt,401790,9,6,3,3,1
jdt,401941,18,14,4,4,1
jdt,519674,8,6,2,2,1
jdt,448794,6,4,2,2,1
jdt,500747,10,8,2,1,1
jdt,400871,2,1,1,1,1
jdt,429958,14,10,4,1,1
jdt,517841,19,18,1,1,1
jdt,422468,19,11,8,1,1
jdt,135217,8,7,1,1,1
jdt,46612,6,5,1,1,1
jdt,425040,4,3,1,1,1
jdt,247564,101,80,21,1,1
jdt,366003,2,0,2,2,1
jdt,415790,2,1,1,1,1
jdt,508889,23,17,6,5,1
jdt,450442,2,1,1,1,1
jdt,326950,5,3,2,2,1
jdt,477476,17,10,7,6,1
jdt,486988,39,27,12,9,1
jdt,383600,5,4,1,1,1
jdt,461268,4,3,1,1,1
jdt,437444,53,41,12,3,1
jdt,480992,46,23,23,7,1
jdt,427744,2,1,1,1,1
jdt,427438,4,2,2,2,1
jdt,78931,12,5,7,7,1
jdt,435570,7,3,4,1,1
jdt,490010,28,22,6,6,1
jdt,390784,31,19,12,3,1
jdt,473901,20,15,5,1,1
jdt,371732,19,10,9,9,1
jdt,477291,66,51,15,14,1
jdt,370540,49,26,23,23,1
jdt,399778,8,5,3,3,1
jdt,404285,2,1,1,1,1
jdt,422489,8,5,3,2,1
jdt,407191,20,16,4,1,1
jdt,501034,23,13,10,8,1
jdt,506430,14,10,4,4,1
jdt,426366,3,2,1,1,1
jdt,479610,46,27,19,16,1
jdt,360328,5,4,1,1,1
jdt,414444,7,3,4,4,1
jdt,418000,12,8,4,4,1
jdt,342054,17,12,5,5,1
jdt,383624,10,9,1,1,1
jdt,402198,7,4,3,2,1
jdt,413613,21,12,9,6,1
p2,242007,2,1,1,1,1
p2,305064,7,3,4,4,1
p2,293340,10,8,2,2,1
p2,214391,19,12,7,7,1
p2,305031,13,4,9,9,1
p2,209992,15,8,7,4,1
p2,309539,40,14,26,25,1
p2,268884,11,7,4,2,1
p2,273668,2,1,1,1,1
p2,269720,4,3,1,1,1
p2,460627,8,6,2,2,1
p2,223447,2,1,1,1,1
p2,216026,23,19,4,3,1
p2,219605,6,5,1,1,1
p2,264042,5,2,3,3,1
p2,227817,11,8,3,3,1
p2,203009,16,9,7,7,1
p2,222498,6,5,1,1,1
p2,225324,16,6,10,5,1
p2,213602,14,9,5,5,1
p2,265217,19,13,6,3,1
p2,250680,3,2,1,1,1
p2,332314,9,8,1,1,1
p2,309874,13,10,3,1,1
p2,221087,6,5,1,1,1
p2,265315,6,5,1,1,1
p2,305069,3,2,1,1,1
p2,192467,12,6,6,6,1
p2,521121,19,16,3,3,1
p2,214640,16,14,2,2,1
p2,262503,2,1,1,1,1
p2,521145,17,8,9,9,1
p2,190923,21,18,3,1,1
p2,297253,7,4,3,3,1
p2,466249,10,6,4,4,1
p2,525735,13,11,2,2,1
p2,274025,8,5,3,2,1
p2,521842,6,4,2,2,1
p2,525599,18,14,4,4,1
p2,297255,27,18,9,8,1
p2,204470,9,7,2,2,1
p2,221710,14,10,4,4,1
p2,222565,18,10,8,6,1
p2,203323,18,10,8,8,1
p2,212348,37,24,13,12,1
p2,290207,12,7,5,4,1
p2,256412,7,4,3,3,1
p2,304280,6,4,2,2,1
p2,231590,2,1,1,1,1
p2,209576,5,4,1,1,1
p2,210450,7,5,2,2,1
p2,294691,111,63,48,35,1
p2,206388,7,5,2,2,1
p2,216278,82,54,28,24,1
p2,252685,18,12,6,3,1
p2,297259,14,9,5,4,1
p2,525708,7,4,3,2,1
p2,268205,11,6,5,4,1
p2,242768,14,12,2,2,1
p2,273674,5,2,3,1,1
p2,301292,17,12,5,5,1
p2,204301,10,7,3,1,1
p2,206077,32,28,4,4,1
p2,525733,6,3,3,2,1
p2,252690,11,8,3,2,1
p2,215924,7,5,2,1,1
p2,203011,53,33,20,15,1
p2,521156,29,26,3,3,1
p2,261928,29,24,5,5,1
p2,212047,26,19,7,5,1
p2,302183,17,15,2,2,1
p2,224472,7,4,3,3,1
p2,214524,36,31,5,4,1
p2,262333,25,19,6,3,1
p2,205544,13,12,1,1,1
p2,521115,11,7,4,4,1
p2,302201,6,0,6,6,1
p2,329386,2,0,2,1,1
p2,265550,11,8,3,1,1
p2,200380,27,14,13,13,1
p2,260012,11,6,5,5,1
p2,210006,45,41,4,4,1
p2,216028,19,14,5,3,1
p2,221031,15,11,4,4,1
p2,262611,2,1,1,1,1
p2,398853,11,8,3,1,1
p2,250862,30,25,5,4,1
p2,215103,5,4,1,1,1
p2,305237,2,1,1,1,1
p2,222501,4,1,3,3,1
p2,255913,57,34,23,23,1
p2,301903,22,12,10,7,1
p2,204402,35,29,6,4,1
p2,321819,40,30,10,4,1
p2,207802,5,4,1,1,1
p2,269496,15,10,5,5,1
p2,190041,17,12,5,4,1
p2,219109,7,4,3,3,1
p2,232440,4,3,1,1,1
p2,250452,14,9,5,5,1
p2,224504,9,8,1,1,1
p2,203340,5,4,1,1,1
p2,300450,2,1,1,1,1
p2,208294,11,8,3,3,1
p2,212295,19,14,5,5,1
p2,260066,10,7,3,2,1
p2,212607,4,3,1,1,1
p2,252694,7,6,1,1,1
p2,300132,8,3,5,5,1
p2,263272,125,92,33,15,1
p2,223423,23,21,2,2,1
p2,227784,6,5,1,1,1
p2,194224,9,8,1,1,1
p2,248951,16,14,2,1,1
p2,210986,5,1,4,4,1
p2,260950,13,8,5,5,1
p2,205223,46,37,9,8,1
p2,225755,60,35,25,21,1
p2,303264,5,2,3,3,1
p2,258105,2,1,1,1,1
p2,212644,14,13,1,1,1
p2,291620,10,4,6,4,1
p2,260913,34,20,14,14,1
p2,211679,13,7,6,6,1
p2,203543,15,9,6,4,1
p2,206898,12,11,1,1,1
p2,219477,4,2,2,1,1
p2,486279,7,5,2,2,1
p2,422054,24,23,1,1,1
swt,509091,3,2,1,1,1
swt,485821,71,42,29,29,1
swt,513052,2,1,1,1,1
swt,497807,2,1,1,1,1
swt,428514,9,2,7,7,1
swt,512342,9,6,3,3,1
swt,506585,6,2,4,4,1
swt,458863,13,6,7,6,1
swt,513037,35,21,14,13,1
swt,444715,1,0,1,1,1
swt,334147,19,11,8,8,1
swt,509086,29,19,10,8,1
swt,502845,28,14,14,14,1
jdt,438875,0,0,0,0,0
jdt,392245,0,0,0,0,0
jdt,261600,0,0,0,0,0
jdt,421897,0,0,0,0,0
jdt,102572,0,0,0,0,0
jdt,76190,0,0,0,0,0
jdt,401769,0,0,0,0,0
jdt,407414,2,1,1,0,0
jdt,427626,0,0,0,0,0
jdt,429384,3,3,0,0,0
jdt,425798,0,0,0,0,0
jdt,272711,1,1,0,0,0
jdt,477387,4,4,0,0,0
jdt,401847,0,0,0,0,0
jdt,428019,7,6,1,0,0
jdt,140521,0,0,0,0,0
jdt,418743,0,0,0,0,0
jdt,416176,3,3,0,0,0
jdt,443596,0,0,0,0,0
jdt,382353,0,0,0,0,0
jdt,473657,0,0,0,0,0
jdt,519963,0,0,0,0,0
jdt,415308,0,0,0,0,0
jdt,519673,0,0,0,0,0
jdt,507571,1,1,0,0,0
jdt,23126,1,1,0,0,0
jdt,415043,5,5,0,0,0
jdt,114115,1,1,0,0,0
jdt,421628,0,0,0,0,0
jdt,22072,0,0,0,0,0
jdt,406773,0,0,0,0,0
jdt,405134,0,0,0,0,0
jdt,405068,2,2,0,0,0
jdt,508079,0,0,0,0,0
jdt,402080,1,0,1,0,0
jdt,492858,3,3,0,0,0
jdt,402812,2,2,0,0,0
jdt,484114,0,0,0,0,0
jdt,177174,0,0,0,0,0
jdt,518794,0,0,0,0,0
jdt,418599,0,0,0,0,0
jdt,365992,1,1,0,0,0
jdt,466713,6,4,2,0,0
jdt,474239,0,0,0,0,0
jdt,38111,3,3,0,0,0
jdt,178138,0,0,0,0,0
jdt,473178,15,15,0,0,0
jdt,176132,0,0,0,0,0
jdt,449846,4,2,2,0,0
jdt,516731,0,0,0,0,0
jdt,406973,0,0,0,0,0
jdt,416190,1,1,0,0,0
jdt,171019,2,2,0,0,0
jdt,400556,2,2,0,0,0
jdt,392384,3,3,0,0,0
jdt,435805,3,2,1,0,0
jdt,501162,9,9,0,0,0
jdt,418979,2,2,0,0,0
jdt,430073,3,3,0,0,0
jdt,224750,1,1,0,0,0
jdt,287164,0,0,0,0,0
jdt,429430,0,0,0,0,0
jdt,453483,3,3,0,0,0
jdt,516377,0,0,0,0,0
jdt,425183,0,0,0,0,0
jdt,508624,10,8,2,0,0
jdt,427483,2,1,1,0,0
jdt,495801,4,4,0,0,0
jdt,452788,1,1,0,0,0
jdt,395886,1,1,0,0,0
jdt,513790,1,1,0,0,0
jdt,427199,1,1,0,0,0
jdt,437072,0,0,0,0,0
jdt,370639,2,1,1,0,0
jdt,25928,0,0,0,0,0
jdt,414761,0,0,0,0,0
jdt,521362,0,0,0,0,0
jdt,500716,1,1,0,0,0
jdt,401030,0,0,0,0,0
jdt,230885,1,0,1,0,0
jdt,497518,3,3,0,0,0
jdt,520335,4,4,0,0,0
jdt,520995,0,0,0,0,0
jdt,430136,0,0,0,0,0
jdt,426984,4,2,2,0,0
jdt,525208,1,1,0,0,0
jdt,400905,3,3,0,0,0
jdt,429262,3,3,0,0,0
jdt,3243,0,0,0,0,0
jdt,515792,0,0,0,0,0
jdt,448914,0,0,0,0,0
jdt,403132,0,0,0,0,0
jdt,378674,0,0,0,0,0
jdt,427072,2,2,0,0,0
jdt,365531,0,0,0,0,0
jdt,265744,0,0,0,0,0
jdt,356746,4,4,0,0,0
jdt,133491,1,1,0,0,0
jdt,185220,3,3,0,0,0
jdt,403086,0,0,0,0,0
jdt,496142,0,0,0,0,0
jdt,426537,0,0,0,0,0
jdt,448954,9,7,2,0,0
jdt,148115,0,0,0,0,0
jdt,404489,3,3,0,0,0
jdt,334783,6,6,0,0,0
jdt,527260,7,7,0,0,0
jdt,424205,1,1,0,0,0
jdt,391893,1,1,0,0,0
jdt,409245,1,1,0,0,0
jdt,402993,0,0,0,0,0
jdt,402233,9,8,1,0,0
jdt,26025,4,4,0,0,0
jdt,460491,4,4,0,0,0
jdt,382721,4,4,0,0,0
jdt,478143,5,5,0,0,0
jdt,399224,2,2,0,0,0
jdt,232880,0,0,0,0,0
jdt,509612,0,0,0,0,0
jdt,365859,2,2,0,0,0
jdt,162865,0,0,0,0,0
jdt,210521,0,0,0,0,0
jdt,485748,4,4,0,0,0
jdt,410892,5,2,3,0,0
jdt,448792,4,3,1,0,0
jdt,466291,0,0,0,0,0
jdt,519151,0,0,0,0,0
jdt,493222,0,0,0,0,0
jdt,371832,0,0,0,0,0
jdt,519493,4,2,2,0,0
jdt,424914,1,1,0,0,0
jdt,66271,4,4,0,0,0
jdt,90612,0,0,0,0,0
jdt,338118,1,1,0,0,0
jdt,386692,0,0,0,0,0
jdt,388281,0,0,0,0,0
jdt,23162,5,3,2,0,0
jdt,520795,0,0,0,0,0
jdt,392099,8,8,0,0,0
jdt,458577,2,2,0,0,0
jdt,500503,0,0,0,0,0
jdt,148944,12,9,3,0,0
jdt,446442,0,0,0,0,0
jdt,506888,0,0,0,0,0
jdt,345305,0,0,0,0,0
jdt,421473,0,0,0,0,0
jdt,178039,4,2,2,0,0
jdt,497355,0,0,0,0,0
jdt,488659,0,0,0,0,0
jdt,129584,5,4,1,0,0
jdt,424286,2,2,0,0,0
jdt,58582,2,2,0,0,0
jdt,376550,4,4,0,0,0
jdt,495863,1,1,0,0,0
jdt,261973,0,0,0,0,0
jdt,519444,5,5,0,0,0
jdt,441726,0,0,0,0,0
jdt,485057,2,2,0,0,0
jdt,474081,1,1,0,0,0
jdt,424167,11,6,5,0,0
jdt,127575,20,12,8,0,0
jdt,382069,0,0,0,0,0
jdt,405517,0,0,0,0,0
jdt,132679,2,2,0,0,0
jdt,409236,0,0,0,0,0
jdt,461372,4,4,0,0,0
jdt,428795,0,0,0,0,0
jdt,94965,3,3,0,0,0
jdt,412151,3,3,0,0,0
jdt,401845,13,6,7,0,0
jdt,404649,2,2,0,0,0
jdt,511949,0,0,0,0,0
jdt,430336,1,1,0,0,0
jdt,383913,0,0,0,0,0
jdt,499589,1,1,0,0,0
jdt,368546,12,12,0,0,0
jdt,28268,0,0,0,0,0
jdt,433458,1,1,0,0,0
jdt,500636,10,8,2,0,0
jdt,424198,0,0,0,0,0
jdt,365387,0,0,0,0,0
jdt,447573,0,0,0,0,0
jdt,297825,0,0,0,0,0
jdt,507795,0,0,0,0,0
jdt,29536,1,1,0,0,0
jdt,509366,0,0,0,0,0
jdt,520656,0,0,0,0,0
jdt,415850,0,0,0,0,0
jdt,507061,0,0,0,0,0
jdt,402831,0,0,0,0,0
jdt,429012,1,1,0,0,0
jdt,402219,2,1,1,0,0
jdt,59788,2,2,0,0,0
jdt,190612,3,3,0,0,0
jdt,506461,3,3,0,0,0
jdt,418235,2,2,0,0,0
jdt,485988,0,0,0,0,0
jdt,455723,0,0,0,0,0
jdt,381172,0,0,0,0,0
jdt,401610,0,0,0,0,0
jdt,83548,0,0,0,0,0
jdt,449262,0,0,0,0,0
jdt,426462,0,0,0,0,0
jdt,349326,0,0,0,0,0
jdt,434483,0,0,0,0,0
jdt,372012,0,0,0,0,0
jdt,416182,0,0,0,0,0
jdt,511574,0,0,0,0,0
jdt,405071,0,0,0,0,0
jdt,424138,1,1,0,0,0
jdt,484926,9,6,3,0,0
jdt,188559,0,0,0,0,0
jdt,365519,0,0,0,0,0
jdt,395002,0,0,0,0,0
jdt,415291,0,0,0,0,0
jdt,512914,1,1,0,0,0
jdt,423885,12,9,3,0,0
jdt,388996,0,0,0,0,0
jdt,488494,3,3,0,0,0
jdt,447579,0,0,0,0,0
jdt,521896,6,5,1,0,0
jdt,77359,2,2,0,0,0
jdt,421017,0,0,0,0,0
jdt,394768,0,0,0,0,0
jdt,399537,0,0,0,0,0
jdt,382701,2,2,0,0,0
jdt,520826,1,1,0,0,0
jdt,400761,0,0,0,0,0
jdt,410218,9,9,0,0,0
jdt,383908,0,0,0,0,0
jdt,407297,0,0,0,0,0
jdt,408230,3,2,1,0,0
jdt,416307,0,0,0,0,0
jdt,495062,10,10,0,0,0
jdt,399791,0,0,0,0,0
jdt,414113,1,1,0,0,0
jdt,24127,0,0,0,0,0
jdt,506438,0,0,0,0,0
jdt,488442,1,1,0,0,0
jdt,391464,1,1,0,0,0
jdt,482075,2,2,0,0,0
jdt,472177,4,4,0,0,0
jdt,515342,1,1,0,0,0
jdt,237241,1,1,0,0,0
jdt,417295,8,8,0,0,0
jdt,392862,2,2,0,0,0
jdt,511814,0,0,0,0,0
jdt,403810,0,0,0,0,0
jdt,403410,0,0,0,0,0
jdt,520329,0,0,0,0,0
jdt,458396,1,1,0,0,0
jdt,417113,0,0,0,0,0
jdt,526591,2,2,0,0,0
jdt,442614,1,1,0,0,0
jdt,60081,1,1,0,0,0
jdt,421035,0,0,0,0,0
jdt,430195,3,2,1,0,0
jdt,227855,1,0,1,0,0
jdt,512791,0,0,0,0,0
jdt,457079,0,0,0,0,0
jdt,382727,0,0,0,0,0
jdt,342598,0,0,0,0,0
jdt,500467,1,1,0,0,0
jdt,185010,5,5,0,0,0
jdt,152123,2,2,0,0,0
jdt,399770,0,0,0,0,0
jdt,430035,0,0,0,0,0
jdt,79752,0,0,0,0,0
jdt,484361,1,1,0,0,0
jdt,510467,1,1,0,0,0
jdt,44984,6,6,0,0,0
jdt,424080,2,2,0,0,0
jdt,515875,4,4,0,0,0
jdt,405104,2,2,0,0,0
jdt,193909,5,5,0,0,0
jdt,446317,0,0,0,0,0
jdt,346529,3,3,0,0,0
jdt,80839,0,0,0,0,0
jdt,510053,0,0,0,0,0
jdt,385780,0,0,0,0,0
jdt,417803,0,0,0,0,0
jdt,492488,4,4,0,0,0
jdt,404986,0,0,0,0,0
jdt,498362,0,0,0,0,0
jdt,488662,0,0,0,0,0
jdt,521847,0,0,0,0,0
jdt,439750,0,0,0,0,0
jdt,65259,0,0,0,0,0
jdt,165900,1,1,0,0,0
jdt,521058,2,2,0,0,0
jdt,479134,1,1,0,0,0
jdt,83713,10,10,0,0,0
jdt,405843,0,0,0,0,0
jdt,510002,1,1,0,0,0
jdt,479119,1,1,0,0,0
jdt,365662,3,2,1,0,0
jdt,525432,0,0,0,0,0
jdt,437522,3,3,0,0,0
jdt,497719,1,1,0,0,0
jdt,401222,3,3,0,0,0
jdt,490988,0,0,0,0,0
jdt,439516,0,0,0,0,0
jdt,515600,0,0,0,0,0
jdt,428305,0,0,0,0,0
jdt,405067,0,0,0,0,0
jdt,359334,2,2,0,0,0
jdt,423504,8,8,0,0,0
jdt,477790,5,5,0,0,0
jdt,399773,8,8,0,0,0
jdt,429813,9,7,2,0,0
jdt,424053,2,0,2,0,0
jdt,522328,1,1,0,0,0
jdt,133005,1,1,0,0,0
jdt,446765,3,3,0,0,0
jdt,430150,0,0,0,0,0
jdt,342757,0,0,0,0,0
jdt,429090,0,0,0,0,0
jdt,466556,1,1,0,0,0
jdt,413592,4,3,1,0,0
jdt,430667,0,0,0,0,0
jdt,406392,0,0,0,0,0
jdt,360164,0,0,0,0,0
jdt,202467,0,0,0,0,0
jdt,358903,4,3,1,0,0
jdt,410207,0,0,0,0,0
jdt,428352,1,1,0,0,0
jdt,403147,0,0,0,0,0
jdt,409250,3,3,0,0,0
jdt,39739,0,0,0,0,0
jdt,440687,3,3,0,0,0
jdt,419165,2,2,0,0,0
jdt,495557,0,0,0,0,0
jdt,107389,0,0,0,0,0
jdt,24308,0,0,0,0,0
jdt,493296,2,2,0,0,0
jdt,509328,2,1,1,0,0
jdt,406319,2,2,0,0,0
jdt,488663,0,0,0,0,0
jdt,522073,5,5,0,0,0
jdt,517326,2,2,0,0,0
jdt,72105,0,0,0,0,0
jdt,125641,1,1,0,0,0
jdt,497168,0,0,0,0,0
jdt,405066,0,0,0,0,0
jdt,456497,0,0,0,0,0
jdt,487716,1,1,0,0,0
jdt,401850,1,1,0,0,0
jdt,526615,1,1,0,0,0
jdt,428003,5,2,3,0,0
jdt,406388,0,0,0,0,0
jdt,521287,0,0,0,0,0
jdt,425134,3,3,0,0,0
jdt,381443,0,0,0,0,0
jdt,487586,0,0,0,0,0
jdt,500265,1,1,0,0,0
jdt,29864,0,0,0,0,0
jdt,374605,0,0,0,0,0
jdt,170692,0,0,0,0,0
jdt,392238,0,0,0,0,0
jdt,423505,0,0,0,0,0
jdt,500622,0,0,0,0,0
jdt,423987,1,1,0,0,0
jdt,479104,0,0,0,0,0
jdt,490657,0,0,0,0,0
jdt,88298,2,2,0,0,0
jdt,412149,4,4,0,0,0
jdt,426792,3,3,0,0,0
jdt,391890,0,0,0,0,0
jdt,419918,1,1,0,0,0
jdt,119244,7,7,0,0,0
jdt,350000,3,3,0,0,0
jdt,500905,2,2,0,0,0
jdt,440759,3,2,1,0,0
jdt,482247,0,0,0,0,0
jdt,96918,1,1,0,0,0
jdt,401551,8,8,0,0,0
jdt,509994,1,1,0,0,0
jdt,428526,1,1,0,0,0
jdt,500362,0,0,0,0,0
jdt,518401,8,8,0,0,0
jdt,365437,1,1,0,0,0
jdt,42253,9,8,1,0,0
jdt,228464,1,1,0,0,0
jdt,510339,0,0,0,0,0
jdt,518282,3,2,1,0,0
jdt,418041,4,4,0,0,0
jdt,406530,0,0,0,0,0
jdt,402173,7,7,0,0,0
jdt,447695,0,0,0,0,0
jdt,393719,0,0,0,0,0
jdt,458208,0,0,0,0,0
jdt,497996,0,0,0,0,0
jdt,197050,2,2,0,0,0
jdt,258917,4,4,0,0,0
jdt,23284,7,7,0,0,0
jdt,31652,1,1,0,0,0
jdt,488885,4,4,0,0,0
jdt,527531,1,1,0,0,0
jdt,150228,4,4,0,0,0
jdt,463330,1,1,0,0,0
jdt,514653,3,3,0,0,0
jdt,421165,1,1,0,0,0
jdt,338234,13,5,8,0,0
jdt,434600,1,1,0,0,0
jdt,420660,0,0,0,0,0
jdt,399780,1,1,0,0,0
jdt,359495,0,0,0,0,0
jdt,124525,0,0,0,0,0
jdt,496123,0,0,0,0,0
jdt,418347,3,3,0,0,0
jdt,369079,0,0,0,0,0
jdt,145367,1,1,0,0,0
jdt,406170,0,0,0,0,0
jdt,11076,5,2,3,0,0
jdt,339139,0,0,0,0,0
jdt,145329,1,1,0,0,0
jdt,449619,2,2,0,0,0
jdt,406614,3,3,0,0,0
p2,268138,1,1,0,0,0
p2,310667,0,0,0,0,0
p2,247524,0,0,0,0,0
p2,202464,0,0,0,0,0
p2,301305,1,1,0,0,0
p2,248783,4,4,0,0,0
p2,407115,0,0,0,0,0
p2,222480,4,4,0,0,0
p2,270542,2,2,0,0,0
p2,256364,16,16,0,0,0
p2,229342,0,0,0,0,0
p2,460967,1,1,0,0,0
p2,271342,0,0,0,0,0
p2,228523,10,10,0,0,0
p2,223341,4,4,0,0,0
p2,264570,10,10,0,0,0
p2,208601,35,30,5,0,0
p2,521075,0,0,0,0,0
p2,212058,3,3,0,0,0
p2,228481,0,0,0,0,0
p2,418662,8,6,2,0,0
p2,220554,3,3,0,0,0
p2,250457,12,8,4,0,0
p2,229641,3,3,0,0,0
p2,279309,0,0,0,0,0
p2,217001,11,11,0,0,0
p2,204184,0,0,0,0,0
p2,208111,6,6,0,0,0
p2,228272,3,3,0,0,0
p2,309873,0,0,0,0,0
p2,299586,0,0,0,0,0
p2,301658,0,0,0,0,0
p2,233198,2,2,0,0,0
p2,217272,3,3,0,0,0
p2,407099,0,0,0,0,0
p2,311475,0,0,0,0,0
p2,300860,6,6,0,0,0
p2,295399,0,0,0,0,0
p2,230314,0,0,0,0,0
p2,208965,3,3,0,0,0
p2,214937,0,0,0,0,0
p2,207493,0,0,0,0,0
p2,234036,0,0,0,0,0
p2,302283,2,2,0,0,0
p2,219214,1,1,0,0,0
p2,218623,0,0,0,0,0
p2,255678,4,4,0,0,0
p2,304843,1,1,0,0,0
p2,290973,1,1,0,0,0
p2,518031,6,6,0,0,0
p2,215927,15,15,0,0,0
p2,249133,4,4,0,0,0
p2,250184,0,0,0,0,0
p2,336246,0,0,0,0,0
p2,262109,3,3,0,0,0
p2,244628,0,0,0,0,0
p2,261637,2,2,0,0,0
p2,387115,1,1,0,0,0
p2,260625,0,0,0,0,0
p2,221256,2,2,0,0,0
p2,224150,4,4,0,0,0
p2,210418,0,0,0,0,0
p2,233027,0,0,0,0,0
p2,204347,1,1,0,0,0
p2,235288,1,1,0,0,0
p2,214694,0,0,0,0,0
p2,284798,1,1,0,0,0
p2,514885,2,2,0,0,0
p2,212334,0,0,0,0,0
p2,313447,0,0,0,0,0
p2,207513,0,0,0,0,0
p2,228999,3,3,0,0,0
p2,204177,5,5,0,0,0
p2,406984,12,11,1,0,0
p2,211650,1,1,0,0,0
p2,214705,8,8,0,0,0
p2,256650,0,0,0,0,0
p2,272954,0,0,0,0,0
p2,525654,1,1,0,0,0
p2,214135,4,4,0,0,0
p2,300240,0,0,0,0,0
p2,219825,1,1,0,0,0
p2,219962,0,0,0,0,0
p2,521108,4,4,0,0,0
p2,222563,8,8,0,0,0
p2,232094,0,0,0,0,0
p2,208251,5,5,0,0,0
p2,218232,1,1,0,0,0
p2,291748,1,1,0,0,0
p2,252890,0,0,0,0,0
p2,224004,0,0,0,0,0
p2,250188,2,2,0,0,0
p2,274096,0,0,0,0,0
p2,211102,4,4,0,0,0
p2,242457,0,0,0,0,0
p2,227582,14,11,3,0,0
p2,230508,5,5,0,0,0
p2,302990,0,0,0,0,0
p2,310206,2,1,1,0,0
p2,234016,0,0,0,0,0
p2,233201,1,1,0,0,0
p2,210462,0,0,0,0,0
p2,224445,0,0,0,0,0
p2,218639,0,0,0,0,0
p2,228046,10,10,0,0,0
p2,303128,1,1,0,0,0
p2,396420,0,0,0,0,0
p2,331683,0,0,0,0,0
p2,521163,0,0,0,0,0
p2,218649,0,0,0,0,0
p2,258722,0,0,0,0,0
p2,330338,3,3,0,0,0
p2,205232,9,8,1,0,0
p2,203115,0,0,0,0,0
p2,525707,2,2,0,0,0
p2,249996,0,0,0,0,0
p2,269978,0,0,0,0,0
p2,275089,0,0,0,0,0
p2,208307,0,0,0,0,0
p2,381673,2,2,0,0,0
p2,322477,0,0,0,0,0
p2,525709,1,1,0,0,0
p2,215930,0,0,0,0,0
p2,264724,2,2,0,0,0
p2,498116,2,2,0,0,0
p2,263593,3,3,0,0,0
p2,270323,1,1,0,0,0
p2,256361,2,2,0,0,0
p2,222870,6,4,2,0,0
p2,525734,4,4,0,0,0
p2,222309,0,0,0,0,0
p2,287558,1,1,0,0,0
p2,220854,10,10,0,0,0
p2,421798,2,1,1,0,0
p2,306439,0,0,0,0,0
p2,255724,0,0,0,0,0
p2,212898,2,2,0,0,0
p2,235526,0,0,0,0,0
p2,304895,0,0,0,0,0
p2,397183,0,0,0,0,0
p2,254931,0,0,0,0,0
p2,274569,2,2,0,0,0
p2,525698,12,12,0,0,0
p2,224269,1,1,0,0,0
p2,234154,2,2,0,0,0
p2,222621,2,2,0,0,0
p2,229305,0,0,0,0,0
p2,212662,1,1,0,0,0
p2,525516,0,0,0,0,0
p2,209366,2,2,0,0,0
p2,272336,4,4,0,0,0
p2,525653,8,8,0,0,0
p2,179563,14,10,4,0,0
p2,210685,0,0,0,0,0
p2,489706,9,9,0,0,0
p2,212461,2,2,0,0,0
p2,290206,4,4,0,0,0
p2,209261,6,6,0,0,0
p2,215406,0,0,0,0,0
p2,210670,0,0,0,0,0
p2,253224,0,0,0,0,0
p2,313553,4,4,0,0,0
p2,303269,3,3,0,0,0
p2,274272,14,14,0,0,0
p2,259598,2,2,0,0,0
p2,305334,0,0,0,0,0
p2,212336,1,1,0,0,0
p2,214691,6,6,0,0,0
p2,233761,0,0,0,0,0
p2,260752,2,2,0,0,0
p2,342661,0,0,0,0,0
p2,214782,5,5,0,0,0
p2,261403,2,2,0,0,0
p2,303990,0,0,0,0,0
p2,272066,5,4,1,0,0
p2,272386,3,3,0,0,0
p2,266939,2,2,0,0,0
p2,222156,5,5,0,0,0
p2,219224,5,5,0,0,0
p2,343329,2,2,0,0,0
p2,211934,1,1,0,0,0
p2,221513,1,1,0,0,0
p2,299818,2,2,0,0,0
p2,227372,1,1,0,0,0
p2,229183,4,4,0,0,0
p2,406986,0,0,0,0,0
p2,229066,2,2,0,0,0
p2,208003,22,21,1,0,0
p2,384646,0,0,0,0,0
p2,231138,4,4,0,0,0
p2,207978,28,28,0,0,0
p2,320613,0,0,0,0,0
p2,299917,0,0,0,0,0
p2,218532,0,0,0,0,0
p2,324355,2,2,0,0,0
p2,262243,2,2,0,0,0
p2,521147,3,3,0,0,0
p2,341737,2,2,0,0,0
p2,225018,0,0,0,0,0
p2,257431,0,0,0,0,0
p2,256037,4,4,0,0,0
p2,369834,0,0,0,0,0
p2,217942,1,1,0,0,0
p2,214704,1,1,0,0,0
p2,206202,0,0,0,0,0
p2,224999,16,14,2,0,0
p2,230253,0,0,0,0,0
p2,232329,0,0,0,0,0
p2,255984,10,8,2,0,0
p2,521838,0,0,0,0,0
p2,300928,2,2,0,0,0
p2,273177,2,2,0,0,0
p2,270668,0,0,0,0,0
p2,325611,0,0,0,0,0
p2,275404,3,3,0,0,0
p2,222445,22,19,3,0,0
p2,224482,7,7,0,0,0
p2,216433,0,0,0,0,0
p2,226528,12,12,0,0,0
p2,264389,3,2,1,0,0
p2,223128,2,2,0,0,0
p2,345209,1,1,0,0,0
p2,251015,3,3,0,0,0
p2,275975,0,0,0,0,0
p2,222567,1,1,0,0,0
p2,521827,13,11,2,0,0
p2,202985,4,4,0,0,0
p2,431116,0,0,0,0,0
p2,525499,0,0,0,0,0
p2,220605,11,11,0,0,0
p2,209541,2,2,0,0,0
p2,179317,1,1,0,0,0
p2,423628,0,0,0,0,0
p2,291696,4,4,0,0,0
p2,229877,0,0,0,0,0
p2,209852,0,0,0,0,0
p2,514863,1,1,0,0,0
p2,209549,1,1,0,0,0
p2,521839,0,0,0,0,0
p2,272483,1,1,0,0,0
p2,400854,0,0,0,0,0
p2,302278,0,0,0,0,0
p2,525796,0,0,0,0,0
p2,253782,2,2,0,0,0
p2,229689,1,1,0,0,0
p2,263546,1,1,0,0,0
p2,258539,0,0,0,0,0
p2,232413,0,0,0,0,0
p2,436872,0,0,0,0,0
p2,247377,0,0,0,0,0
p2,220786,0,0,0,0,0
p2,218451,2,1,1,0,0
p2,204290,1,1,0,0,0
p2,258132,0,0,0,0,0
p2,304942,0,0,0,0,0
p2,255858,1,1,0,0,0
p2,227220,7,6,1,0,0
p2,207976,0,0,0,0,0
p2,274011,1,1,0,0,0
p2,220125,1,1,0,0,0
p2,207220,11,9,2,0,0
p2,263487,0,0,0,0,0
p2,495726,2,2,0,0,0
p2,215560,3,3,0,0,0
p2,235652,7,7,0,0,0
p2,259792,3,3,0,0,0
p2,227042,1,1,0,0,0
p2,181297,1,1,0,0,0
p2,228903,1,1,0,0,0
p2,241477,1,1,0,0,0
p2,200605,2,2,0,0,0
p2,225250,1,1,0,0,0
p2,306279,0,0,0,0,0
p2,272795,1,1,0,0,0
p2,250883,4,4,0,0,0
p2,211922,1,1,0,0,0
p2,516095,0,0,0,0,0
p2,316916,6,6,0,0,0
p2,274319,0,0,0,0,0
p2,304130,1,1,0,0,0
p2,216193,0,0,0,0,0
p2,222639,0,0,0,0,0
p2,264110,3,3,0,0,0
p2,325095,0,0,0,0,0
p2,217927,0,0,0,0,0
p2,262298,2,2,0,0,0
p2,335414,1,1,0,0,0
p2,208439,6,6,0,0,0
p2,334519,0,0,0,0,0
p2,488504,0,0,0,0,0
p2,324873,7,6,1,0,0
p2,226116,0,0,0,0,0
p2,521119,0,0,0,0,0
p2,233699,6,6,0,0,0
p2,217744,0,0,0,0,0
p2,421935,1,1,0,0,0
p2,344851,1,1,0,0,0
p2,216044,7,7,0,0,0
p2,525501,2,2,0,0,0
p2,217100,0,0,0,0,0
p2,247058,3,3,0,0,0
p2,289866,0,0,0,0,0
p2,279015,0,0,0,0,0
p2,218252,9,9,0,0,0
p2,194665,8,8,0,0,0
p2,209680,0,0,0,0,0
p2,518574,0,0,0,0,0
p2,264769,0,0,0,0,0
p2,432634,2,2,0,0,0
p2,358842,4,4,0,0,0
p2,206088,3,3,0,0,0
p2,221727,3,3,0,0,0
p2,222957,0,0,0,0,0
p2,218741,1,1,0,0,0
p2,250316,0,0,0,0,0
p2,205447,0,0,0,0,0
p2,232632,0,0,0,0,0
p2,422026,1,1,0,0,0
p2,199806,2,2,0,0,0
p2,220280,0,0,0,0,0
p2,217748,6,5,1,0,0
p2,259800,0,0,0,0,0
p2,210585,3,3,0,0,0
swt,490864,0,0,0,0,0
swt,522211,4,2,2,0,0
swt,520983,1,1,0,0,0
swt,428512,8,8,0,0,0
swt,518542,0,0,0,0,0
swt,314622,2,2,0,0,0
swt,481467,6,6,0,0,0
swt,444725,0,0,0,0,0
swt,441791,0,0,0,0,0
swt,487493,0,0,0,0,0
swt,497809,3,3,0,0,0
swt,521024,4,4,0,0,0
swt,484541,2,2,0,0,0
swt,474049,3,3,0,0,0
swt,79391,1,1,0,0,0
swt,457659,1,1,0,0,0
swt,509135,0,0,0,0,0
swt,476529,1,1,0,0,0
swt,524692,0,0,0,0,0
swt,490853,1,1,0,0,0
